60;16
26;	26;	32;	0;	0;	0;	0;	27;	26;	26;	26;	26;	26;	26;	26;	26;	32;	0;	0;	0;	0;	0;	0;	0;	0;	0;	0;	0;	0;	0;	0;	0;	0;	0;	0;	0;	0;	0;	0;	0;	0;	0;	0;	0;	0;	0;	0;	0;	0;	0;	0;	0;	0;	0;	0;	0;	0;	0;	0;	0
26;	32;	0;	0;	0;	0;	0;	0;	27;	26;	26;	26;	26;	26;	26;	32;	0;	0;	0;	0;	0;	0;	0;	0;	0;	0;	0;	0;	0;	0;	0;	0;	0;	0;	0;	0;	0;	0;	0;	0;	0;	0;	0;	0;	0;	0;	0;	0;	0;	0;	0;	0;	0;	0;	0;	0;	0;	0;	0;	0
26;	0;	35;	0;	0;	0;	0;	0;	0;	27;	11;	11;	26;	26;	32;	0;	0;	0;	0;	0;	0;	0;	0;	0;	0;	0;	0;	0;	0;	0;	0;	0;	0;	0;	0;	0;	0;	0;	0;	0;	0;	0;	0;	0;	0;	0;	0;	0;	0;	0;	0;	0;	0;	0;	0;	0;	0;	0;	0;	0
26;	0;	0;	0;	0;	0;	0;	0;	0;	0;	0;	0;	27;	32;	0;	0;	0;	0;	0;	0;	0;	0;	0;	0;	0;	0;	0;	0;	0;	0;	0;	0;	0;	0;	0;	0;	0;	0;	0;	36;	0;	0;	35;	35;	0;	0;	0;	0;	0;	0;	0;	0;	0;	0;	0;	0;	0;	0;	0;	0
26;	32;	0;	0;	0;	0;	0;	0;	0;	0;	0;	0;	0;	0;	0;	0;	0;	0;	0;	0;	0;	0;	0;	0;	0;	0;	0;	0;	0;	0;	0;	0;	0;	0;	0;	0;	0;	0;	0;	6;	0;	0;	0;	0;	28;	14;	0;	0;	35;	37;	35;	37;	0;	0;	0;	0;	0;	0;	0;	0
26;	0;	0;	0;	0;	0;	0;	0;	0;	0;	0;	0;	0;	0;	0;	0;	0;	0;	0;	0;	0;	0;	0;	0;	0;	0;	0;	0;	0;	0;	0;	0;	0;	0;	0;	0;	0;	0;	0;	0;	0;	19;	20;	20;	32;	0;	0;	0;	19;	20;	20;	20;	20;	14;	0;	0;	0;	0;	0;	0
2;	0;	0;	0;	0;	0;	0;	0;	0;	0;	0;	0;	0;	0;	0;	0;	0;	0;	0;	0;	0;	0;	0;	0;	0;	0;	0;	0;	0;	0;	0;	0;	0;	0;	0;	0;	0;	0;	0;	0;	0;	0;	27;	32;	0;	0;	0;	0;	0;	0;	0;	0;	0;	0;	0;	0;	35;	0;	0;	0
3;	0;	0;	0;	0;	0;	0;	0;	0;	0;	0;	0;	0;	0;	0;	0;	0;	0;	0;	0;	0;	0;	0;	0;	0;	0;	0;	0;	0;	0;	0;	0;	0;	0;	0;	0;	0;	0;	0;	0;	0;	0;	0;	0;	0;	0;	0;	0;	0;	0;	0;	0;	0;	0;	0;	0;	6;	0;	0;	0
3;	0;	0;	0;	0;	0;	0;	0;	0;	0;	0;	0;	0;	0;	0;	0;	0;	0;	0;	0;	0;	0;	0;	0;	0;	0;	0;	0;	0;	0;	0;	0;	0;	0;	0;	0;	0;	0;	0;	0;	0;	0;	0;	0;	0;	0;	0;	0;	0;	0;	0;	0;	0;	0;	0;	0;	0;	0;	0;	0
3;	0;	0;	0;	0;	0;	0;	0;	0;	0;	0;	0;	0;	0;	0;	0;	0;	0;	0;	0;	0;	0;	0;	0;	0;	0;	0;	0;	0;	0;	0;	0;	0;	0;	0;	0;	35;	0;	0;	0;	0;	0;	0;	0;	0;	0;	0;	0;	35;	0;	0;	0;	0;	0;	19;	14;	0;	0;	0;	0
3;	0;	0;	0;	0;	0;	0;	0;	0;	0;	0;	0;	0;	0;	0;	0;	0;	0;	0;	0;	0;	0;	0;	0;	0;	0;	0;	0;	0;	0;	0;	0;	0;	0;	0;	0;	0;	0;	0;	0;	0;	0;	0;	0;	0;	0;	0;	0;	0;	0;	0;	0;	37;	0;	0;	0;	0;	0;	0;	0
3;	0;	0;	0;	0;	0;	0;	0;	0;	0;	0;	0;	35;	0;	0;	0;	0;	0;	0;	0;	0;	0;	0;	0;	0;	0;	0;	0;	0;	0;	0;	19;	20;	14;	0;	0;	0;	0;	0;	35;	0;	0;	0;	0;	19;	14;	0;	0;	0;	0;	19;	20;	14;	0;	0;	0;	0;	0;	0;	0
3;	0;	0;	0;	0;	0;	0;	0;	0;	0;	35;	35;	35;	35;	0;	0;	0;	0;	0;	0;	0;	0;	0;	37;	37;	37;	37;	37;	0;	0;	0;	0;	0;	0;	0;	0;	0;	0;	0;	0;	0;	37;	0;	0;	0;	0;	0;	0;	0;	0;	0;	0;	0;	0;	0;	0;	0;	0;	0;	0
13;	20;	20;	20;	20;	20;	20;	20;	20;	20;	20;	20;	20;	20;	20;	20;	20;	23;	0;	0;	28;	20;	20;	20;	20;	20;	20;	20;	20;	23;	0;	0;	0;	0;	0;	0;	0;	19;	20;	20;	20;	20;	14;	0;	0;	0;	0;	0;	0;	0;	0;	0;	0;	0;	0;	0;	0;	0;	0;	0
26;	26;	26;	26;	26;	26;	26;	26;	26;	26;	26;	26;	26;	26;	26;	26;	26;	3;	0;	0;	8;	26;	26;	26;	26;	26;	26;	26;	26;	3;	0;	0;	0;	0;	0;	0;	0;	0;	0;	0;	0;	0;	0;	0;	0;	0;	0;	0;	0;	0;	0;	0;	0;	0;	0;	0;	0;	0;	0;	0
26;	26;	26;	26;	26;	26;	26;	26;	26;	26;	26;	26;	26;	26;	26;	26;	26;	3;	0;	0;	8;	26;	26;	26;	26;	26;	26;	26;	26;	3;	0;	0;	0;	0;	0;	0;	0;	0;	0;	0;	0;	0;	0;	0;	0;	0;	0;	0;	0;	0;	0;	0;	0;	0;	0;	0;	0;	0;	0;	0
